-2 cancelled (ยกเลิก) ไม่สามารถแก้ไขได้ต้องเริ่มทำใหม่ตั้งแต่ต้น
-1 rejected(ปฏิเสธแล้ว) ยังเอากลับมาแก้ไขได้โดยไปเริ่มที่ step แรก
0 pending(รอดำเนินการ)
1 submitted(ส่งแล้ว)
2 in progress(กำลังดำเนินการ) เมื่อเปิดเข้ามาในหน้างาน
3 verified(ยืนยันความถูกต้องแล้ว)
4 approved (อนุมัติแล้ว)
5 completed (เสร็จสิ้น)
6 closed (ปิดแล้ว)

Submit เป็นการกระทำของการส่งหรือยื่นบางสิ่งบางอย่าง
Permit เป็นการให้สิทธิ์หรือการอนุญาตให้ทำบางสิ่งบางอย่าง
Confirm เป็นการตรวจสอบหรือยืนยันความถูกต้องของบางสิ่งบางอย่าง หรือการตอบรั 

สถานะเริ่มต้น:
Draft (ร่าง): เอกสารหรือรายการที่อยู่ในระหว่างการสร้างหรือแก้ไขเบื้องต้น ยังไม่พร้อมสำหรับการดำเนินการต่อไป
Pending (รอดำเนินการ): รายการถูกสร้างขึ้นแล้ว แต่กำลังรอการดำเนินการในขั้นตอนถัดไป (อาจรอการอนุมัติ, การตรวจสอบ, หรือการมอบหมาย)
Submitted (ส่งแล้ว): รายการถูกส่งเพื่อเข้าสู่กระบวนการ workflow อย่างเป็นทางการ

สถานะการตรวจสอบข้อมูลหรือรายการแล้ว:
Checked: ตรงไปตรงมาและเข้าใจง่าย
Verified: หมายถึงได้รับการยืนยันความถูกต้องแล้ว
Inspected: หากมีการตรวจสอบอย่างละเอียด
Reviewed: หากเป็นการตรวจสอบและพิจารณา
Validated: หากเป็นการตรวจสอบและรับรองตามเกณฑ์ 

สถานะระหว่างดำเนินการ:
In Progress (กำลังดำเนินการ): รายการกำลังถูกดำเนินการหรือทำงานโดยผู้รับผิดชอบ
Waiting (รอ): รายการกำลังรอการตอบสนอง ข้อมูล หรือการอนุมัติจากบุคคลอื่นหรือระบบอื่น
Review (กำลังตรวจสอบ): รายการถูกส่งให้ผู้มีอำนาจตรวจสอบหรือให้ความคิดเห็น
Verification (กำลังตรวจสอบความถูกต้อง): รายการกำลังถูกตรวจสอบเพื่อให้แน่ใจว่าข้อมูลถูกต้องและครบถ้วน
Assigned (มอบหมายแล้ว): รายการถูกมอบหมายให้กับผู้รับผิดชอบในการดำเนินการ

สถานะสิ้นสุด:
Approved (อนุมัติแล้ว): รายการได้รับการอนุมัติและสามารถดำเนินการในขั้นตอนถัดไปหรือถือว่าเสร็จสิ้น
Rejected (ปฏิเสธแล้ว): รายการไม่ได้รับการอนุมัติและอาจถูกส่งกลับเพื่อแก้ไขหรือยกเลิก
Completed (เสร็จสิ้น): รายการได้ถูกดำเนินการจนเสร็จสมบูรณ์ตามกระบวนการ
Closed (ปิดแล้ว): รายการถูกปิดและไม่ต้องการการดำเนินการใดๆ เพิ่มเติม (อาจเป็นสถานะหลังจาก Completed)
Cancelled (ยกเลิก): รายการถูกยกเลิกและจะไม่มีการดำเนินการต่อ

สถานะงวดงาน
สร้างใหม่ (Created) - สถานะเริ่มต้นเมื่อสร้างงวดงาน
รออนุมัติ (Waiting for Approval) - รอกระบวนการอนุมัติ
อนุมัติแล้ว (Approved) - ผ่านการอนุมัติแล้ว
ไม่อนุมัติ (Rejected) - ไม่ผ่านการอนุมัติ
กำลังดำเนินการ (In Progress) - งานกำลังดำเนินการ
รอตรวจรับงาน (Waiting for Inspection) - งานเสร็จ รอการตรวจรับ
ตรวจรับงานแล้ว (Inspected) - ผ่านการตรวจรับงานแล้ว
รอจ่ายเงิน (Waiting for Payment) - รอการจ่ายเงิน
จ่ายเงินแล้ว (Paid) - จ่ายเงินเรียบร้อย
เสร็จสิ้น (Completed) - งวดงานเสร็จสมบูรณ์